0 0 0 0 0 0 0 0 0 0 0 0 0 0 0 0 0 0 0 0 0 0 0 0 0 0 0 0 0 0 0 0 0 0 0 0 0 0 0 0 0 0 0 0 0 0 0 0 0 0 
0 0 0 0 0 0 0 0 0 0 0 0 0 0 0 0 0 0 0 0 0 0 0 0 0 0 0 0 0 0 0 0 0 0 0 0 0 0 0 0 0 0 0 0 0 0 0 0 0 0 
0 0 0 0 0 0 0 0 0 0 0 0 0 0 0 0 0 0 0 0 0 0 0 0 0 0 0 0 0 0 0 0 0 0 0 0 0 0 0 0 0 0 0 0 0 0 0 0 0 0 
0 0 0 0 0 0 0 0 0 0 0 0 0 0 0 0 0 0 0 0 0 0 0 0 0 0 0 0 0 0 0 0 0 0 0 0 0 0 0 0 0 0 0 0 0 0 0 0 0 0 
0 0 0 0 0 0 0 0 0 0 0 0 0 0 0 0 0 0 0 0 0 0 0 0 0 0 0 0 0 0 0 0 0 0 0 0 0 0 0 0 0 0 0 0 0 0 0 0 0 0 
0 0 0 0 0 0 0 0 0 0 0 0 0 0 0 0 0 0 0 0 0 0 0 0 0 0 0 0 0 0 0 0 0 0 0 0 0 0 0 0 0 0 0 0 0 0 0 0 0 0 
0 0 0 0 0 0 0 0 0 0 0 0 0 0 0 0 0 0 0 0 0 0 0 0 0 0 0 0 0 0 0 0 0 0 0 0 0 0 0 0 0 0 0 0 0 0 0 0 0 0 
0 0 0 0 0 0 0 0 0 48 42 48 48 42 48 48 48 48 0 0 0 0 0 0 0 0 0 0 0 0 0 0 0 0 0 0 0 0 0 0 0 0 0 0 0 0 0 0 0 0 
0 0 0 0 0 0 42 48 42 48 46 46 38 45 46 46 46 48 48 0 0 0 0 0 0 0 0 0 0 0 0 0 0 0 0 32 32 32 32 32 32 32 32 32 32 32 32 0 0 0 
0 0 0 0 0 48 42 48 46 38 46 45 46 47 47 45 45 46 48 48 0 0 0 0 0 0 0 0 0 0 0 0 0 0 0 32 17 17 17 17 17 17 17 17 17 17 32 0 0 0 
0 0 0 0 0 48 46 47 38 39 39 45 47 38 45 47 38 39 38 48 0 0 0 0 0 0 0 0 0 0 0 0 0 0 0 32 17 17 17 17 17 17 17 17 17 17 32 0 0 0 
0 0 0 0 48 48 38 45 45 39 45 45 45 39 46 47 45 46 45 48 0 0 0 0 0 0 0 0 0 0 0 0 0 0 0 32 17 17 17 17 17 17 17 17 17 17 32 0 0 0 
0 0 0 0 48 46 47 47 47 46 45 47 46 47 45 39 45 47 38 48 0 0 0 0 0 0 0 0 0 0 0 0 0 0 0 32 17 17 17 17 17 17 17 17 17 17 32 0 0 0 
0 0 0 0 48 46 46 45 39 45 45 47 45 39 45 38 45 38 38 48 0 0 0 0 0 0 0 0 0 0 0 0 0 0 0 32 32 32 32 38 32 32 32 32 32 32 32 0 0 0 
0 0 0 0 48 48 48 38 39 39 46 46 45 47 47 38 47 48 48 48 0 0 0 0 0 0 0 0 0 0 0 0 0 0 0 0 0 0 42 38 42 0 0 0 0 0 0 0 0 0 
0 0 0 0 0 0 48 48 42 48 48 48 48 38 48 48 48 48 0 0 0 0 0 0 0 0 0 0 0 0 0 0 0 0 0 0 0 0 42 38 42 0 0 0 0 0 0 0 0 0 
0 0 0 0 0 0 0 0 0 0 0 0 42 38 48 0 0 0 0 0 0 0 0 0 0 0 0 0 0 0 0 0 0 0 0 0 0 0 42 38 42 0 0 0 0 0 0 0 0 0 
0 0 0 0 0 0 0 0 0 0 0 0 42 38 48 0 0 0 0 0 0 0 0 0 0 0 0 0 0 0 0 0 0 0 0 0 0 0 42 38 42 0 0 0 0 0 0 0 0 0 
0 0 0 0 0 0 0 0 0 0 0 0 42 38 48 0 0 0 0 0 0 0 0 0 0 0 0 0 0 0 0 0 0 0 0 0 0 0 42 38 42 0 0 0 0 0 0 0 0 0 
0 0 0 0 0 0 0 0 0 0 0 0 48 38 48 0 0 0 0 0 0 0 0 0 0 0 0 0 0 0 0 0 0 0 0 0 0 0 41 38 42 0 0 0 0 0 0 0 0 0 
0 0 0 0 0 0 0 0 0 0 0 0 48 38 48 0 0 0 0 0 0 0 0 0 0 0 0 0 0 0 0 0 0 0 0 0 0 0 41 38 45 0 0 0 0 0 0 0 0 0 
48 42 48 42 0 0 0 0 0 48 48 48 42 38 48 48 48 0 0 0 0 0 0 0 0 0 0 0 0 0 0 0 0 0 0 0 0 0 41 38 45 0 0 0 0 0 0 0 0 0 
48 38 38 48 48 0 0 0 0 42 38 38 38 38 38 38 48 0 0 0 0 0 0 40 40 40 40 40 40 40 40 40 0 0 0 0 0 0 41 38 45 0 0 0 0 0 0 0 0 0 
48 38 38 38 48 0 0 0 0 48 38 38 38 38 38 38 48 0 0 0 0 0 0 40 46 46 39 39 46 46 39 40 0 0 0 0 0 0 41 38 45 0 0 0 0 0 0 0 0 0 
42 38 38 38 48 48 48 42 48 48 38 38 38 38 38 38 48 48 48 48 48 48 48 40 38 38 39 39 39 39 46 40 48 48 48 48 48 48 48 38 48 0 0 0 0 0 0 0 0 0 
48 38 38 38 38 38 38 38 38 38 38 38 38 38 38 38 38 38 38 38 38 38 38 38 46 46 46 47 46 38 47 46 47 47 46 47 46 46 47 47 48 0 0 0 0 0 0 0 0 0 
42 38 38 38 38 42 48 42 42 42 38 38 38 38 38 38 40 48 48 40 48 48 48 40 39 38 39 47 38 38 47 40 48 48 48 48 48 48 48 47 48 0 0 0 0 0 0 0 0 0 
48 38 38 38 38 48 0 0 0 42 38 38 38 38 38 38 48 0 0 0 0 0 0 40 40 40 40 40 40 40 40 40 0 0 0 0 0 0 48 47 48 0 0 0 0 0 0 0 0 0 
48 48 38 38 38 42 0 0 0 48 48 40 48 38 38 38 40 0 0 0 0 0 0 0 0 0 0 0 0 0 0 0 0 0 0 0 0 0 48 47 48 0 0 0 0 0 0 0 0 0 
0 48 42 48 48 48 0 0 0 0 0 0 48 48 38 48 48 0 0 0 0 0 0 0 0 0 0 0 0 0 0 0 0 0 0 32 32 32 48 47 48 32 32 32 0 0 0 0 0 0 
0 0 0 0 0 0 0 0 0 0 0 0 0 48 38 40 0 0 0 0 0 0 0 0 0 0 0 0 0 0 0 0 0 0 32 32 39 39 39 39 39 39 39 38 32 0 0 0 0 0 
0 0 0 0 0 0 0 0 0 0 0 0 0 48 38 40 0 0 0 0 0 0 0 0 0 0 0 0 0 0 0 0 0 0 32 47 47 47 38 38 38 38 38 38 38 32 0 0 0 0 
0 0 0 0 0 0 0 0 0 0 0 0 0 48 38 48 0 0 0 0 0 0 0 0 0 0 0 0 0 0 0 0 0 0 32 47 38 38 38 38 47 47 38 38 38 32 32 0 0 0 
0 0 0 0 0 0 0 0 0 0 0 0 0 48 38 40 0 0 0 0 0 0 0 0 0 0 0 0 0 0 0 0 0 0 32 47 47 38 38 47 47 47 47 38 38 38 32 0 0 0 
0 0 0 0 0 0 0 0 0 0 0 0 0 48 38 48 0 0 0 0 0 0 0 0 0 0 0 0 0 0 0 0 0 0 32 47 47 38 38 47 38 38 47 38 38 38 32 0 0 0 
0 0 0 0 0 0 0 0 0 0 0 0 0 48 38 48 0 0 0 0 0 0 0 0 0 0 0 0 0 0 0 0 0 0 32 32 47 38 38 38 38 38 38 38 38 38 32 0 0 0 
0 0 0 0 0 0 0 0 0 0 0 0 0 48 38 40 0 0 0 0 0 0 0 0 0 0 0 0 0 0 0 0 0 0 0 32 32 47 47 38 38 38 38 38 38 32 0 0 0 0 
0 0 0 0 0 0 0 0 0 0 0 0 0 48 38 48 0 0 0 0 0 0 0 0 0 0 0 0 0 0 0 0 0 0 0 0 32 32 32 32 32 32 32 32 32 0 0 0 0 0 
0 0 0 0 0 48 48 48 45 48 45 48 48 48 38 48 43 43 43 43 43 43 43 0 0 0 0 0 0 0 0 0 0 0 0 0 0 0 0 0 0 0 0 0 0 0 0 0 0 0 
0 0 0 0 0 48 38 38 38 48 48 48 47 38 38 38 38 38 38 38 38 38 43 0 0 0 0 0 0 0 0 0 0 0 0 0 0 0 0 0 0 0 0 0 0 0 0 0 0 0 
0 0 0 0 0 45 38 48 38 38 38 47 38 44 39 44 44 44 44 38 48 38 43 0 0 0 0 0 0 0 0 0 0 0 0 0 0 0 0 0 0 0 0 0 0 0 0 0 0 0 
0 0 0 0 0 48 38 48 48 48 47 48 46 44 47 47 47 47 44 38 44 38 43 0 0 0 0 0 0 0 0 0 0 0 0 0 0 0 0 0 0 0 0 0 0 0 0 0 0 0 
0 0 0 0 0 48 38 47 38 38 38 48 38 48 39 39 38 38 38 38 44 47 43 0 0 0 0 0 0 0 0 0 0 0 0 0 0 0 0 0 0 0 0 0 0 0 0 0 0 0 
0 0 0 0 0 45 38 38 38 48 38 48 39 48 39 44 47 44 39 39 44 38 43 0 0 0 0 0 0 0 0 0 0 0 0 0 0 0 0 0 0 0 0 0 0 0 0 0 0 0 
0 0 0 0 0 48 38 48 38 48 38 48 38 48 39 44 47 44 44 44 44 38 43 0 0 0 0 0 0 0 0 0 0 0 0 0 0 0 0 0 0 0 0 0 0 0 0 0 0 0 
0 0 0 0 0 45 38 48 38 47 47 38 38 39 39 44 38 38 38 47 38 38 45 0 0 0 0 0 0 0 0 0 0 0 0 0 0 0 0 0 0 0 0 0 0 0 0 0 0 0 
0 0 0 0 0 45 38 48 48 45 48 48 48 45 48 44 38 44 48 48 48 48 48 0 0 0 0 0 0 0 0 0 0 0 0 0 0 0 0 0 0 0 0 0 0 0 0 0 0 0 
0 0 0 0 0 48 38 38 46 38 38 46 38 39 38 38 39 38 38 38 39 38 45 0 0 0 0 0 0 0 0 0 0 0 0 0 0 0 0 0 0 0 0 0 0 0 0 0 0 0 
0 0 0 0 0 48 48 43 48 48 43 48 48 43 48 43 48 43 48 43 48 48 48 0 0 0 0 0 0 0 0 0 0 0 0 0 0 0 0 0 0 0 0 0 0 0 0 0 0 0 
0 0 0 0 0 0 0 0 0 0 0 0 0 0 0 0 0 0 0 0 0 0 0 0 0 0 0 0 0 0 0 0 0 0 0 0 0 0 0 0 0 0 0 0 0 0 0 0 0 0 
