5 5 5 5 5 5 5 5 5 5 5 5 5
5 5 5 5 5 5 5 5 5 5 5 5 5
5 5 1 1 1 1 1 1 1 1 1 5 5
5 5 1 0 6 0 0 7 0 7 1 5 5
5 5 1 0 7 0 7 0 6 0 1 5 5
5 5 1 6 7 0 6 0 6 0 1 5 5
5 5 1 0 6 6 0 7 0 7 1 5 5
5 5 1 6 0 0 0 2 0 0 1 5 5
5 5 1 0 6 0 6 7 0 6 1 5 5
5 5 1 1 0 6 0 6 6 0 1 5 5
5 5 5 1 1 1 1 1 1 1 1 5 5
5 5 5 5 5 5 5 5 5 5 5 5 5
5 5 5 5 5 5 5 5 5 5 5 5 5
