19 19 19 19 19 19 19 19 19 19 19 19 19 19 19 19 19 19 19 19 19 19 19 19 19 19 19 19 19 19 19 19 19 19 19 19 19 19 19 19 19 19 19 19 19 19 19 19 19 19 
19 19 19 19 19 19 19 19 19 19 19 19 19 19 19 19 19 19 19 19 19 19 19 19 19 19 19 19 19 19 19 19 19 19 19 19 19 19 19 19 19 19 19 19 19 19 19 19 19 19 
19 19 19 19 19 19 19 19 19 19 19 19 19 19 19 19 19 19 19 19 19 19 19 19 19 19 19 19 19 19 19 19 19 19 19 19 19 19 19 19 19 19 19 19 19 19 19 19 19 19 
19 19 19 19 19 19 19 19 19 19 19 19 19 19 19 19 19 19 19 19 19 19 19 19 19 19 19 19 19 19 19 19 19 19 19 19 19 19 19 19 19 19 19 19 19 19 19 19 19 19 
19 19 19 19 19 19 19 19 19 19 19 19 19 19 19 19 19 19 19 19 19 19 19 19 19 19 19 19 19 19 19 19 19 19 19 19 19 19 19 19 19 19 19 19 19 19 19 19 19 19 
19 19 19 19 19 19 19 19 19 19 19 19 19 19 19 19 19 19 19 19 19 19 19 19 19 19 19 19 19 19 19 19 19 19 19 19 19 19 19 19 19 19 19 19 19 19 19 19 19 19 
19 19 19 19 19 19 19 19 19 19 19 19 19 19 19 19 19 19 19 19 19 19 19 19 19 19 19 19 19 19 19 19 19 19 19 19 19 19 19 19 19 19 19 19 19 19 19 19 19 19 
19 19 19 19 19 19 19 19 19 19 19 19 19 19 19 19 19 19 19 19 19 19 19 19 19 19 19 19 19 19 19 19 19 19 19 19 19 19 19 19 19 19 19 19 19 19 19 19 19 19 
19 19 19 19 19 19 19 19 19 19 19 19 19 19 19 19 19 19 19 19 28 26 26 26 26 26 26 26 26 29 19 19 19 19 19 19 19 19 19 19 19 19 19 19 19 19 19 19 19 19 
19 19 19 19 19 19 19 19 19 19 19 19 19 19 19 19 28 26 26 26 27 2 2 2 2 2 2 2 2 25 26 26 26 29 19 19 19 19 19 19 19 19 19 19 19 19 19 19 19 19 
19 19 19 19 19 19 19 19 19 19 19 19 19 19 19 19 24 2 2 2 1 2 2 2 2 16 2 2 2 2 2 2 2 25 26 29 19 19 19 19 19 19 19 19 19 19 19 19 19 19 
19 19 19 19 19 19 19 19 19 19 19 19 19 19 28 26 27 2 2 2 2 20 21 21 21 21 21 21 21 21 22 2 1 2 2 25 26 26 29 19 19 19 19 19 19 19 19 19 19 19 
19 19 19 19 19 19 19 19 19 19 19 19 28 26 27 2 2 2 2 2 2 23 18 19 19 18 18 19 19 18 30 22 2 1 2 2 2 2 23 19 19 19 19 19 19 19 19 19 19 19 
19 19 19 19 19 19 19 19 19 19 19 19 24 2 2 2 2 2 16 2 2 25 26 29 19 19 19 18 18 28 26 27 2 2 2 16 2 2 25 26 29 19 19 19 19 19 19 19 19 19 
19 19 19 28 26 26 26 26 26 29 19 19 24 2 2 2 2 2 2 2 2 2 2 25 26 26 26 26 26 27 2 2 2 1 2 2 2 2 2 2 23 19 19 19 19 19 19 19 19 19 
19 19 19 24 2 2 2 2 2 25 26 29 30 21 21 21 22 2 2 16 1 2 2 2 1 2 2 2 2 2 2 2 2 16 1 2 2 20 21 21 31 19 19 19 19 19 19 19 19 19 
19 19 19 24 2 2 2 2 2 2 2 25 29 19 19 19 30 22 2 2 2 2 2 2 2 2 16 2 2 16 2 2 2 2 2 2 20 31 19 19 19 19 19 19 19 19 19 19 19 19 
19 19 28 27 2 2 2 2 2 2 2 2 23 19 19 19 19 30 21 21 21 21 21 21 21 21 22 2 2 20 21 21 21 21 21 21 31 19 19 19 19 19 19 19 19 19 19 19 19 19 
19 19 24 2 2 2 2 2 2 2 2 2 23 19 19 19 19 19 19 19 19 19 19 19 19 19 24 2 2 23 19 19 19 19 19 19 19 19 19 19 19 19 19 19 19 19 19 19 19 19 
19 19 24 2 2 2 2 2 2 2 2 2 23 19 19 19 19 19 19 19 19 19 19 19 19 19 24 2 2 23 19 19 19 19 19 19 19 19 19 19 19 19 19 19 19 19 19 19 19 19 
19 19 30 22 2 2 2 2 2 2 2 2 23 19 19 19 19 19 19 19 19 19 19 19 19 19 24 2 2 23 19 19 19 19 19 19 19 19 19 19 19 19 19 19 19 19 19 19 19 19 
19 19 19 30 21 21 22 2 2 2 2 20 31 19 18 18 18 18 18 19 18 19 19 28 26 26 27 2 2 23 19 19 19 19 19 19 19 19 19 19 19 19 19 19 19 19 19 19 19 19 
19 18 19 19 19 19 24 2 2 20 21 31 19 19 18 19 18 18 18 18 18 19 19 24 2 2 1 1 2 25 29 19 19 19 19 19 19 19 19 19 19 19 19 19 28 26 26 29 19 19 
19 18 19 19 19 19 24 2 2 25 29 19 19 19 19 19 19 19 19 19 19 19 19 24 12 10 10 10 10 13 23 19 19 19 19 19 19 19 19 19 19 28 26 26 27 2 2 23 19 19 
19 18 19 19 28 26 27 2 2 2 25 26 29 19 19 19 19 19 19 19 28 26 26 27 8 3 3 3 3 9 25 26 29 19 19 19 19 19 19 19 28 27 2 2 2 2 2 23 19 19 
19 19 19 28 27 2 2 2 2 2 2 2 25 29 19 18 18 18 19 28 27 12 10 10 11 3 3 3 3 3 9 10 25 29 19 19 19 19 19 28 27 2 2 2 2 2 2 25 26 29 
19 19 19 24 2 2 2 2 2 2 2 2 2 25 26 26 26 26 26 27 2 11 3 3 3 3 3 3 3 3 3 3 9 25 26 26 26 26 26 27 2 2 2 2 2 2 2 2 2 23 
19 19 19 24 2 2 2 2 2 2 2 2 2 2 1 1 1 2 2 2 8 3 3 3 3 3 3 3 3 3 3 3 3 7 2 2 2 2 2 2 2 2 2 2 2 2 2 2 2 23 
19 19 19 24 2 2 2 2 2 2 2 2 2 2 2 2 2 2 2 2 14 6 3 3 3 3 3 3 3 3 3 3 3 7 2 2 2 2 2 2 2 2 2 2 2 2 2 2 20 31 
19 19 19 24 2 2 2 2 2 2 2 2 2 2 20 21 21 21 21 22 2 2 6 3 3 3 3 3 3 3 3 3 4 2 20 21 21 21 21 22 2 2 2 2 2 2 2 2 23 19 
19 19 19 30 21 22 2 2 2 2 2 2 2 2 23 19 19 19 19 30 22 2 14 6 3 3 3 3 3 3 3 4 15 20 31 19 19 19 28 27 2 2 2 2 2 2 2 20 31 19 
19 19 19 19 19 24 2 2 2 2 2 2 2 20 31 19 19 19 19 19 30 21 22 14 6 3 3 3 3 4 5 15 20 31 19 19 19 19 24 2 2 1 2 2 2 2 20 31 19 19 
19 19 19 19 19 30 21 21 21 21 21 21 21 31 19 19 19 19 19 19 19 19 30 21 22 5 5 5 5 2 20 21 31 19 18 18 18 19 30 21 22 2 2 2 20 21 31 19 19 19 
19 19 19 19 19 19 19 19 19 19 19 19 19 19 19 19 19 19 19 19 19 19 19 19 30 21 22 2 2 20 31 19 19 19 18 18 19 19 19 19 30 21 21 21 31 19 19 18 18 19 
19 19 19 19 19 19 19 19 19 19 19 19 19 19 19 19 19 19 19 19 19 19 19 19 19 19 24 2 2 23 19 19 18 19 18 19 18 19 19 19 19 19 19 19 19 19 18 18 18 19 
19 19 19 19 19 19 19 19 19 19 19 19 19 19 18 19 18 18 19 19 19 18 19 19 19 19 24 2 2 23 19 18 18 19 19 19 19 18 18 18 18 19 19 19 19 19 19 19 19 19 
19 19 19 19 19 19 19 19 19 19 19 19 19 18 18 19 19 18 19 19 18 18 19 19 19 19 24 2 2 23 19 18 19 19 18 18 18 18 19 19 18 19 19 19 19 19 19 18 19 19 
19 19 19 19 19 19 19 19 19 19 19 19 19 18 19 19 19 19 18 19 19 19 19 19 18 18 24 2 2 23 19 19 19 18 18 18 18 18 19 19 19 19 18 18 19 19 18 18 19 19 
19 19 19 19 19 19 19 19 19 19 19 19 19 19 19 19 18 18 18 19 19 19 19 19 19 18 24 2 2 23 19 19 18 19 19 19 19 19 19 19 19 19 18 18 18 18 19 18 19 19 
19 19 19 19 19 19 19 19 19 19 19 19 18 19 19 19 18 18 19 19 19 19 19 28 26 26 27 2 2 25 26 26 26 26 26 26 29 19 19 19 18 19 19 19 19 18 18 18 19 19 
19 19 19 19 19 19 19 19 19 19 19 19 18 19 19 19 19 19 19 28 26 26 26 27 2 2 2 2 1 2 2 2 2 2 2 2 25 26 26 29 19 19 19 19 19 19 19 19 19 19 
19 19 19 19 19 19 19 19 19 19 19 19 19 18 19 19 19 28 26 27 2 2 2 2 2 2 2 2 2 2 2 2 1 2 2 2 2 2 2 25 29 19 19 19 19 19 19 19 19 19 
19 19 19 19 19 19 19 19 19 19 19 19 19 19 19 19 19 24 2 2 2 1 1 2 2 1 1 2 1 1 1 2 2 1 2 2 2 2 2 2 23 19 19 19 19 19 19 19 19 19 
19 19 19 19 19 19 19 19 19 19 19 19 19 19 19 19 19 24 2 2 1 2 2 2 2 2 1 1 1 2 2 1 1 1 1 2 2 1 1 2 23 19 19 19 19 19 19 19 19 19 
19 19 19 19 19 19 19 19 19 19 19 19 19 19 19 19 19 24 2 2 2 2 2 2 1 1 1 2 2 2 2 1 1 2 2 2 2 2 2 20 31 19 19 19 19 19 19 19 19 19 
19 19 19 19 19 19 19 19 19 19 19 19 19 19 19 19 19 30 22 2 2 2 2 2 2 2 2 2 2 2 1 2 1 2 2 2 2 20 21 31 19 19 19 19 19 19 19 19 19 19 
19 19 19 19 19 19 19 19 19 19 19 19 19 19 19 19 19 19 30 21 21 22 2 2 2 2 2 2 2 2 2 2 2 20 21 21 21 31 19 19 19 19 19 19 19 19 19 19 19 19 
19 19 19 19 19 19 19 19 19 19 19 19 19 19 19 19 19 19 19 19 19 30 21 21 21 21 21 21 21 21 21 21 21 31 19 19 19 19 19 19 19 19 19 19 19 19 19 19 19 19 
19 19 19 19 19 19 19 19 19 19 19 19 19 19 19 19 19 19 19 19 19 19 19 19 19 19 19 19 19 19 19 19 19 19 19 19 19 19 19 19 19 19 19 19 19 19 19 19 19 19 
19 19 19 19 19 19 19 19 19 19 19 19 19 19 19 19 19 19 19 19 19 19 19 19 19 19 19 19 19 19 19 19 19 19 19 19 19 19 19 19 19 19 19 19 19 19 19 19 19 19 
